WWWWWWWWWWWWWWWWWWWWWWWWWWWWWWWWWWWWWWWWWWWWWWWWWWWWWWWWWWWWWWWWWWWWWWWWWW
W                                                                        W
W                                                                        W
W           WWWWWWWWWWWWWW                                               W
W           WWWWWWWWWWWWWW                                               W
W                                                                        W
W                                       WWWWWWWWWWWWWW                   W
W                                       WWWWWWWWWWWWWW                   W
W                                                   WW                   W
W                                                   WW                   W
W      WWWWWWWWWWWWWWWWWWWWWWW                      WW                   W
W      WWWWWWWWWWWWWWWWWWWWWWW                      WW                   W
W                                                   WWWWWWWWWWWWWWWW     W
W                                                   WWWWWWWWWWWWWWWW     W
W                                                                        W
W                                                                        W
W                      WWWWWWWWWWWWWWWWWWWWWWW                           W
W                      WWWWWWWWWWWWWWWWWWWWWWW                           W
W                                           WW                           W
W                                           WW                           W
W                                           WW                           W
W                                           WW                           W
W                      WWWWWWWWWWWWWWWWWWWWWWW         WWWWWWWWWWWWWWWWWWW
W                      WWWWWWWWWWWWWWWWWWWWWWW         WWWWWWWWWWWWWWWWWWW
W                      WW                                                W
W                      WW                                                W
W                      WW                     EE                         W
W                                             EE                         W
W                                                                        W
WWWWWWWWWWWWWWWWWWWWWWWWWWWWWWWWWWWWWWWWWWWWWWWWWWWWWWWWWWWWWWWWWWWWWWWWWW